Antígua e Barbuda - Antiguano
Argentina - Argentino
Bahamas - Bahamense
Barbados - Barbadiano, barbadense
Belize - Belizenho
Bolívia - Boliviano
Brasil - Brasileiro
Chile - Chileno
Colômbia - Colombiano
Costa Rica - Costarriquenho
Cuba - Cubano
Dominica - Dominicano
Equador - Equatoriano
El Salvador - Salvadorenho
Granada - Granadino
Guatemala - Guatemalteco
Guiana - Guianês
Guiana Francesa - Guianense
Haiti - Haitiano
Honduras - Hondurenho
Jamaica - Jamaicano
México - Mexicano
Nicarágua - Nicaraguense
Panamá - Panamenho
Paraguai - Paraguaio
Peru - Peruano
Porto Rico - Portorriquenho
República Dominicana - Dominicana
São Cristóvão e Nevis - São-cristovense
São Vicente e Granadinas - São-vicentino
Santa Lúcia - Santa-lucense
Suriname - Surinamês
Trinidad e Tobago - Trindadense
Uruguai - Uruguaio
Venezuela - Venezuelano
Alemanha - Alemão
Áustria - Austríaco
Bélgica - Belga
Croácia - Croata
Dinamarca - Dinamarquês
Eslováquia - Eslovaco
Eslovênia - Esloveno
Espanha - Espanhol
França - Francês
Grécia - Grego
Hungria - Húngaro
Irlanda - Irlandês
Itália - Italiano
Noruega - Noruego
Países Baixos - Holandês
Polônia - Polonês
Portugal - Português
Reino Unido - Britânico
Inglaterra - Inglês
País de Gales - Galês
Escócia - Escocês
Romênia - Romeno
Rússia - Russo
Sérvio - Sérvio
Suécia - Sueco
Suíça - Suíço
Turquia - Turco
Ucrânia - Ucraniano
Estados Unidos - Americano
Canadá - Canadense
Angola - Angolano
Moçambique - Moçambicano
África do Sul - Sul-africano
Zimbabue - Zimbabuense
Argélia - Argélia
Comores - Comorense
Egito - Egípcio
Líbia - Líbio
Marrocos - Marroquino
Gana - Ganés
Quênia - Queniano
Ruanda - Ruandês
Uganda - Ugandense
Botsuana - Bechuano
Costa do Marfim - Marfinense
Camarões - Camaronense
Nigéria - Nigeriano
Somália - Somali
Austrália - Australiano
Nova Zelândia - Neozelandês
Afeganistão - Afegão
Arábia Saudita - Saudita
Armênia - Armeno
Armeno - Bangladesh
China - Chinês
Coréia do Norte - Norte-coreano, coreano
Coréia do Sul - Sul-coreano, coreano
Índia - Indiano
Indonésia - Indonésio
Iraque - Iraquiano
Irã - Iraniano
Israel - Israelita
Japão - Japonês
Malásia - Malaio
Nepal - Nepalês
Omã - Omanense
Paquistão - Paquistanês
Palestina - Palestino
Qatar - Qatarense
Síria - Sírio
Sri Lanka - Cingalês
Tailândia - Tailandês
Timor-Leste - Timorense, maubere
Emirados Árabes Unidos - Árabe, emiratense
Vietnã - Vietnamita
Iêmen - Iemenita